_,_,_,_,_,_,_,_,_,_,_,_,_,_,_,_,_,_,_,_,_,_,_,_,W,_,_,_,_,_,_,_,_,_,_,_,_,_,E,_,_,_,_,_,_,_,E,_,_,_,_,_,_,_,_,E,E,_,_,_,_,_,_,_,,
_,_,_,_,_,_,_,_,_,_,_,_,_,_,_,_,_,_,_,_,_,_,_,_,W,_,_,_,_,_,_,_,_,_,_,_,_,_,_,_,_,_,_,_,_,_,_,_,_,_,_,_,_,_,_,W,W,_,_,_,_,_,_,_,,
_,_,_,_,_,_,_,_,_,_,_,_,_,_,_,_,_,_,_,_,_,_,_,_,W,_,_,_,_,_,_,_,_,_,_,_,_,_,_,_,_,_,_,_,_,_,_,_,_,_,_,_,_,_,W,W,_,_,_,_,_,_,_,_,,
_,_,_,_,_,_,_,_,_,_,_,_,_,_,_,_,_,_,_,_,_,_,_,_,W,_,_,_,_,_,_,_,_,_,_,_,_,_,_,_,_,_,_,_,_,_,_,_,_,_,_,_,_,W,W,_,_,_,_,_,_,_,_,_,,
_,_,_,_,_,_,_,_,_,_,_,_,_,_,_,_,_,_,_,_,_,_,_,_,W,_,_,_,_,_,_,_,_,_,_,_,_,_,_,_,_,_,_,_,_,_,_,_,_,_,_,_,W,W,_,_,_,_,_,_,_,_,_,_,,
_,_,_,_,_,_,_,_,_,_,_,_,_,_,_,_,_,_,_,_,_,_,_,_,W,_,_,_,_,_,_,_,_,_,_,_,_,_,_,_,_,_,_,_,_,_,_,_,_,_,_,W,W,_,_,_,_,_,_,_,_,_,_,_,,
_,_,_,_,_,_,_,_,_,_,_,_,_,_,_,_,_,_,_,_,_,_,_,_,W,_,_,_,_,_,_,_,_,_,_,_,_,_,_,_,_,_,_,_,_,_,_,_,_,_,W,W,_,_,_,_,_,_,_,_,_,_,_,_,,
_,_,_,_,_,_,_,_,_,_,_,_,_,_,_,_,_,_,_,_,_,_,_,_,W,_,_,_,_,_,_,_,_,_,_,_,_,_,_,_,_,_,_,_,_,_,_,_,_,W,W,_,_,_,_,_,_,_,_,_,_,_,_,_,,
_,_,_,_,_,_,_,_,_,_,_,_,_,_,_,_,_,_,_,_,_,_,_,_,W,_,_,_,_,_,_,_,_,_,_,_,_,_,_,_,_,_,_,_,_,_,_,_,W,W,_,_,_,_,_,_,_,_,_,_,_,_,_,_,,
_,_,_,_,_,_,_,_,_,_,_,_,_,_,_,_,_,_,_,_,_,_,_,_,W,_,_,_,_,_,_,_,_,_,_,_,_,_,_,_,_,_,_,_,_,_,_,W,W,_,_,_,_,_,_,_,_,_,_,_,_,_,_,_,,
_,_,_,_,_,_,_,_,_,_,_,_,_,_,_,_,_,_,_,_,_,_,_,_,W,_,_,_,_,_,_,_,_,_,_,_,_,_,_,_,_,_,_,_,_,_,W,W,_,_,_,_,_,_,_,_,_,_,_,_,_,_,_,_,,
_,_,_,_,_,_,_,_,_,_,_,_,_,_,_,_,_,_,_,_,_,_,_,_,W,_,_,_,_,_,_,_,_,_,_,_,_,_,_,_,_,_,_,_,_,W,W,W,W,W,W,W,W,W,W,W,W,W,W,W,W,W,W,_,,
_,_,_,_,_,_,_,_,_,_,_,_,_,_,_,_,_,_,_,_,_,_,_,_,W,_,_,_,_,_,_,_,_,_,_,_,_,_,_,_,_,_,_,_,W,W,_,_,_,_,_,_,_,_,_,_,E,_,_,_,_,_,_,_,,
_,_,_,_,_,_,_,_,_,_,_,_,_,_,_,_,_,_,_,_,_,_,_,_,W,_,_,_,_,_,_,_,_,_,_,_,_,_,_,_,_,_,_,W,W,_,_,_,_,_,_,_,_,_,_,_,_,_,_,_,_,_,_,_,,
_,_,_,_,_,_,_,_,_,_,_,_,_,_,_,_,_,_,_,_,_,_,_,_,W,_,_,_,_,_,_,_,_,_,_,_,_,_,_,_,_,_,W,W,_,_,_,_,_,_,_,_,F,_,_,_,_,_,_,_,_,_,_,_,,
_,_,_,_,_,_,_,_,_,_,_,_,_,_,_,_,_,_,_,_,_,_,_,_,W,_,_,_,_,_,_,_,_,_,_,_,_,_,_,_,_,W,W,_,_,_,_,_,_,_,_,_,_,_,_,_,_,_,_,_,_,_,_,_,,
_,_,_,_,_,_,_,_,_,_,_,_,_,_,_,_,_,_,_,_,_,_,_,_,_,W,_,_,_,_,_,_,_,_,_,_,_,_,_,_,W,W,_,_,_,_,_,_,_,_,_,_,_,_,_,_,_,_,_,_,_,_,_,_,,
_,_,_,_,_,_,_,_,_,_,_,_,_,_,_,_,_,_,_,_,_,_,_,_,_,_,W,_,_,_,_,_,_,_,_,_,_,_,_,W,W,_,_,E,_,_,_,_,_,_,_,_,_,_,_,_,_,_,_,_,_,_,_,_,,
_,_,_,_,_,_,_,_,_,_,_,_,_,_,_,_,_,_,_,_,_,_,_,_,_,_,_,W,_,_,_,_,_,_,_,_,_,_,W,W,W,W,W,_,W,W,W,W,W,W,W,W,W,W,W,W,W,W,W,W,W,W,W,W,,
_,_,_,_,_,_,_,_,_,_,_,_,_,_,_,_,_,_,_,_,_,_,_,_,_,_,W,_,_,_,_,_,_,_,_,_,_,W,W,_,_,_,_,_,_,_,_,_,_,_,_,_,_,_,_,_,_,_,_,_,_,_,_,_,,
_,_,_,_,_,_,_,_,_,_,_,_,_,_,_,_,_,_,_,_,_,_,_,_,_,W,_,_,_,_,_,_,_,_,_,_,W,W,_,_,_,_,_,_,_,_,_,_,_,_,_,_,_,_,_,_,_,_,_,_,_,_,_,_,,
_,_,_,_,_,_,_,_,_,_,_,_,_,_,_,_,_,_,_,_,_,_,_,_,W,_,_,_,_,_,_,_,_,_,_,W,W,_,_,_,_,_,_,_,_,_,_,_,_,_,_,_,_,_,_,_,_,_,_,_,_,_,_,_,,
_,_,_,_,_,_,_,_,_,_,_,_,_,_,_,_,_,_,_,_,_,_,_,W,_,_,_,_,_,_,_,_,_,_,W,W,_,_,_,_,_,_,_,_,_,_,_,_,_,_,_,_,_,_,_,_,_,_,_,_,_,_,_,_,,
W,W,W,W,W,W,W,W,W,W,W,W,W,W,_,_,_,_,_,_,_,_,W,_,_,_,_,_,_,_,_,_,_,W,W,_,_,_,_,_,_,_,_,_,_,_,_,_,_,_,_,_,_,_,_,_,_,_,_,_,_,_,_,_,,
W,_,_,_,_,_,_,_,_,_,_,_,_,W,_,_,_,_,_,_,_,W,_,_,_,_,_,_,_,_,_,_,W,W,_,_,_,_,_,_,_,_,_,_,_,_,_,_,_,_,_,_,_,_,_,_,_,_,_,_,_,_,_,_,,
W,_,_,_,_,_,_,_,_,_,_,_,_,W,_,_,_,_,_,_,W,_,_,_,_,_,_,_,_,_,_,W,W,_,_,_,_,_,_,_,_,_,_,_,_,_,_,_,_,_,_,_,_,_,_,_,_,_,_,_,_,_,_,_,,
W,_,_,_,_,_,_,_,_,_,_,_,_,W,_,_,_,_,_,W,_,_,_,_,_,_,_,_,_,_,W,W,_,_,_,_,_,_,_,_,_,_,_,_,_,_,_,_,_,_,_,_,_,_,_,_,_,_,_,_,_,_,_,_,,
W,_,_,_,_,_,_,_,_,_,_,_,_,W,_,_,_,_,W,_,_,_,_,_,_,_,_,_,_,W,W,_,_,_,_,_,_,_,_,_,_,_,_,_,_,_,_,_,_,_,_,_,_,_,_,_,_,_,_,_,_,_,_,_,,
W,_,_,_,_,_,_,_,_,_,_,_,_,W,W,W,W,W,_,_,_,_,_,_,_,_,_,_,W,W,_,_,_,_,_,_,_,_,_,_,_,_,_,_,_,_,_,_,_,_,_,_,_,_,_,_,_,_,_,_,_,_,_,_,,
W,_,_,E,_,_,_,_,_,_,_,_,_,_,_,_,_,_,_,_,_,_,_,_,_,_,_,W,W,_,_,_,_,_,_,_,_,_,_,_,_,_,_,_,_,_,_,_,_,_,_,_,_,_,_,_,_,_,_,_,_,_,_,_,,
W,_,_,_,_,_,_,_,_,_,_,_,_,_,_,_,_,_,_E,_,_,_,_,_,_,_,_,_,_,_,_,_,_,_,_,_,_,_,_,_,_,_,_,_,_,_,_,_,_,_,_,_,_,_,_,_,_,_,_,_,_,_,_,_,,
W,W,W,W,W,W,W,_,_,_,_,_,_,W,_,_,_,_,_,_,_,_,_,_,_,_,_,_,_,_,_,_,_,_,_,_,_,_,_,_,_,_,_,_,W,_,_,_,_,_,_,_,_,_,_,_,_,_,_,_,W,W,_,_,,
W,_,_,_,_,_,W,_,_,_,_,_,_,W,_,_,_,_,_,_,_,_,_,W,W,_,_,_,_,_,_,_,_,_,_,_,_,_,_,_,_,_,_,W,W,W,_,_,_,_,W,W,W,_,W,_,_,_,_,_,W,_,_,_,,
W,_,_,_,_,_,_,_,_,_,_,_,_,W,_,_,_,_,_,_,_,_,W,W,_,_,_,_,_,_,_,_,_,_,_,_,_,_,_,_,_,_,_,_,W,_,_,W,W,_,W,_,W,_,_,_,W,W,W,_,W,W,_,W,,
W,_,S,_,_,_,W,_,_,_,_,_,_,W,_,_,_,_,_,_,_,W,W,_,_,_,_,_,_,_,_,_,_,_,_,_,_,_,_,_,_,_,_,_,W,_,_,W,_,_,W,W,W,_,W,_,W,_,W,_,W,_,_,W,,
W,_,_,_,_,_,W,_,_,_,_,_,_,W,_,_,_,_,_,_,W,W,_,_,_,_,_,_,_,_,_,_,_,_,_,_,_,_,_,_,_,_,_,_,W,W,_,W,_,_,W,_,W,_,W,_,W,_,W,_,W,W,_,W,,
