W,W,W,W,W,W,_,_,_,_,_,_,_,_,_,_,_,_,W,W,_,_,_,_,_,_,_,_,_,_,_,_,_,_,_,_,_,_,_,_,_,_,_,_,_,_,_,_,_,_,_,_,_,_,_,W,W,W,_,_,W,W,W,_,
_,_,_,_,W,W,_,_,_,_,_,_,_,_,_,_,_,_,W,W,_,_,_,_,_,_,_,_,_,_,_,_,_,_,_,_,_,_,_,_,_,_,_,_,_,_,_,_,_,_,_,_,_,_,_,W,_,W,_,_,_,W,_,_,
_,_,_,_,W,W,_,_,_,_,_,_,_,_,_,_,_,_,W,W,_,_,_,_,_,_,_,_,_,_,_,_,_,_,_,_,_,_,_,_,_,_,_,_,_,_,_,_,_,_,_,_,_,_,_,W,_,W,_,_,_,W,_,_,
S,_,_,_,W,W,_,_,_,_,_,_,_,_,_,_,_,_,W,W,_,_,_,_,_,_,_,_,_,_,_,_,_,_,_,_,_,_,_,_,_,_,_,_,_,_,_,_,_,_,_,_,_,_,_,W,W,W,_,_,_,W,_,_,
_,_,_,_,W,W,W,W,W,W,_,_,_,_,_,_,_,_,W,W,_,_,_,_,_,_,_,_,_,_,_,_,_,_,_,_,_,_,_,_,_,_,_,_,_,_,_,_,_,_,_,_,_,_,_,W,_,W,_,_,_,W,_,_,
_,_,_,_,W,W,W,W,W,W,_,_,_,_,_,_,_,_,W,W,_,_,_,_,_,_,_,_,_,_,_,_,_,_,_,_,_,_,_,_,_,_,_,_,_,_,_,_,_,_,_,_,_,_,_,W,_,W,_,_,_,W,_,_,
E,_,_,_,_,_,_,_,W,W,_,_,_,_,_,_,_,_,W,W,_,_,_,_,_,_,_,_,_,_,_,_,_,_,_,_,_,_,_,_,_,_,_,_,_,_,_,_,_,_,_,_,_,_,_,W,_,W,_,_,W,W,W,_,
_,_,_,_,_,_,_,_,W,W,_,_,_,_,_,_,_,_,W,W,_,_,_,_,_,_,_,_,_,_,_,_,_,_,_,_,_,_,_,_,_,_,_,_,_,_,_,_,_,_,_,_,_,_,_,_,_,_,_,_,_,_,_,_,
_,_,E,_,_,_,_,_,W,W,_,_,_,_,_,_,_,_,W,W,_,_,_,_,_,_,_,_,_,_,_,_,_,_,_,_,_,_,_,_,_,_,_,_,_,_,_,_,_,_,_,_,_,_,_,_,_,_,_,_,_,_,_,_,
_,_,_,_,_,_,_,_,W,W,W,W,W,W,W,_,_,_,W,W,_,_,_,_,_,_,_,_,_,_,_,_,_,_,_,_,_,_,_,_,_,_,_,_,_,_,_,_,_,_,_,_,_,_,_,_,_,_,_,_,_,_,_,_,
E,_,_,_,_,_,_,_,W,W,W,W,W,W,W,_,_,_,W,W,_,_,_,W,W,W,W,W,W,_,_,_,_,_,_,_,_,_,_,_,_,_,_,_,_,_,_,_,_,_,_,_,_,_,_,_,_,_,_,_,_,_,_,_,
_,_,_,_,_,_,_,_,_,_,_,_,_,W,W,_,_,_,W,W,_,_,W,_,_,_,_,_,W,_,_,_,_,_,_,_,_,_,_,_,_,_,_,_,_,_,_,_,_,_,_,_,_,_,_,_,_,_,_,_,_,_,_,_,
_,_,_,_,_,_,_,_,_,_,_,_,_,W,W,_,_,_,W,W,_,W,_,_,_,_,_,_,W,_,_,_,_,_,_,_,_,_,_,_,_,_,_,_,_,_,_,_,_,_,_,_,_,_,_,_,_,_,_,_,_,_,_,_,
_,_,_,_,_,_,_,_,_,_,_,_,_,W,W,_,_,_,W,W,W,_,_,_,_,_,_,_,W,_,_,_,_,_,_,_,_,_,_,_,_,_,_,_,_,_,_,_,_,_,_,_,_,_,_,_,_,_,_,_,_,_,_,_,
_,_,_,_,_,_,_,_,_,_,_,_,_,W,W,_,_,_,_,_,_,_,_,_,_,_,_,_,W,_,_,_,_,_,_,_,_,_,_,_,_,_,_,_,_,_,_,_,_,_,_,_,_,_,_,_,_,_,_,_,_,_,_,_,
_,_,_,_,_,_,_,_,_,_,_,_,_,W,W,_,_,_,W,W,E,_,_,_,_,_,_,_,W,_,_,_,_,_,_,_,_,_,_,_,_,_,_,_,_,_,_,_,_,_,_,_,_,_,_,_,_,_,_,_,_,_,_,_,
E,_,_,_,_,_,_,_,_,_,_,_,_,W,W,_,_,_,W,W,E,_,_,_,_,_,_,_,W,_,_,_,_,_,_,_,_,_,_,_,_,_,_,_,_,_,_,_,_,_,_,_,_,_,_,_,_,_,_,_,_,_,_,_,
W,W,W,W,W,W,W,W,W,W,W,_,W,W,W,_,_,_,W,W,W,_,_,_,_,_,_,W,_,_,_,_,_,_,_,_,_,_,_,_,_,_,_,_,_,_,_,_,_,_,_,_,_,_,_,_,_,_,_,_,_,_,_,_,
W,W,W,W,W,W,W,W,W,W,W,_,W,W,W,_,_,_,W,W,_,W,_,_,_,_,_,_,W,_,_,_,_,_,_,_,_,_,_,_,_,_,_,_,_,_,_,_,_,_,_,_,_,_,_,_,_,_,_,_,_,_,_,_,
_,_,_,_,_,_,_,_,_,_,_,_,_,W,W,_,_,_,W,W,_,_,W,E,_,_,_,_,_,_,_,_,W,_,_,_,_,_,_,_,_,_,_,_,_,_,_,_,_,_,_,_,_,_,_,_,_,_,_,_,_,_,_,_,
_,_,_,_,_,_,_,_,_,_,_,_,_,W,W,_,_,_,W,W,_,_,_,W,W,W,W,W,W,_,_,_,_,W,_,_,_,_,_,_,_,_,_,_,_,_,_,_,_,_,_,_,_,_,_,_,_,_,_,_,_,_,_,_,
_,_,_,_,_,_,_,_,_,_,_,_,_,W,W,_,_,_,W,W,_,_,_,_,_,_,_,_,_,_,W,_,_,_,W,_,_,_,_,_,_,_,_,_,_,_,_,_,_,_,_,_,_,_,_,_,_,_,_,_,_,_,_,_,
E,_,_,_,_,_,_,_,_,_,_,_,_,W,W,_,_,_,W,W,_,_,_,_,_,_,_,_,_,_,_,W,_,_,_,W,_,_,_,_,_,_,_,_,_,_,_,_,_,_,_,_,_,_,_,_,_,_,_,_,_,_,_,_,
_,_,_,_,_,_,_,_,_,_,_,_,_,W,W,_,_,_,W,W,_,_,_,_,_,_,_,_,_,_,_,_,W,_,_,_,W,_,_,_,_,_,_,_,_,_,_,_,_,_,_,_,_,_,_,_,_,_,_,_,_,_,_,_,
_,_,_,_,_,_,_,_,_,_,_,_,_,W,W,_,_,_,W,W,_,_,_,_,_,_,_,_,_,_,_,_,_,W,_,_,_,W,_,_,_,_,_,_,_,_,_,_,_,_,_,_,_,_,_,_,_,_,_,_,_,_,_,_,
_,_,_,_,_,_,_,_,_,_,_,_,_,W,W,_,_,_,W,W,_,_,_,_,_,_,_,_,_,_,_,_,_,_,W,_,_,_,W,_,_,_,_,_,_,_,_,_,_,_,_,_,_,_,_,_,_,_,_,_,_,_,_,_,
_,_,_,_,_,_,_,_,_,_,_,_,_,W,W,_,_,_,W,W,_,_,_,_,_,_,_,_,_,_,_,_,_,_,_,W,_,_,_,W,_,_,_,_,_,_,_,_,_,_,_,_,_,_,_,_,_,_,_,_,_,_,_,_,
_,_,_,_,_,_,_,_,_,_,_,_,_,W,W,_,_,_,W,W,_,_,_,_,_,_,_,_,_,_,_,_,_,_,_,_,W,_,_,_,W,_,_,_,_,_,_,_,_,_,_,_,_,_,_,_,_,_,_,_,_,_,_,_,
_,_,_,_,_,_,_,_,_,_,_,_,_,W,W,_,_,_,W,W,_,_,_,_,_,_,_,_,_,_,_,_,_,_,_,_,_,W,_,_,_,W,_,_,_,_,_,W,W,W,_,_,_,_,_,_,_,_,_,_,_,_,_,_,
_,_,_,_,_,_,_,_,_,_,_,_,_,W,W,_,_,_,W,W,_,_,_,_,_,_,_,_,_,_,_,_,_,_,_,_,_,_,W,_,_,_,W,_,_,_,W,_,_,_,W,_,_,_,_,_,_,_,_,_,_,_,_,_,
_,_,_,_,_,_,_,_,_,_,_,_,_,W,W,_,_,_,W,W,_,_,_,_,_,_,_,_,_,_,_,_,_,_,_,_,_,_,_,W,_,_,_,W,_,W,_,_,_,_,W,_,_,_,_,_,_,_,_,_,_,_,_,_,
_,_,_,_,_,_,_,_,_,_,_,_,_,W,W,_,_,_,W,W,_,_,_,_,_,_,_,_,_,_,_,_,_,_,_,_,_,_,_,_,W,_,_,_,W,_,_,_,F,_,W,_,_,_,_,_,_,_,_,_,_,_,_,_,
E,_,_,_,_,_,_,_,_,_,_,_,_,_,_,_,_,_,W,W,_,_,_,_,_,_,_,_,_,_,_,_,_,_,_,_,_,_,_,_,_,W,_,E,_,_,_,_,_,_,W,_,_,_,_,_,_,_,_,_,_,_,_,_,
_,_,_,_,_,_,_,_,_,_,_,_,_,W,W,_,_,_,W,W,_,_,_,_,_,_,_,_,_,_,_,_,_,_,_,_,_,_,_,_,_,_,W,E,_,_,_,_,_,_,W,_,_,_,_,_,_,_,_,_,_,_,_,_,
_,_,_,_,_,_,_,_,_,_,_,_,_,W,W,_,_,_,W,W,_,_,_,_,_,_,_,_,_,_,_,_,_,_,_,_,_,_,_,_,_,_,_,W,_,_,_,W,W,W,_,_,_,_,_,_,_,_,_,_,_,_,_,_,
_,_,_,_,_,_,_,_,_,_,_,_,_,W,W,_,_,_,W,W,_,_,_,_,_,_,_,_,_,_,_,_,_,_,_,_,_,_,_,_,_,_,_,_,W,_,_,_,W,_,_,_,_,_,_,_,_,_,_,_,_,_,_,_,
