S,_,0,0,0,_,_,_,_,W,_,_,_,_,_,_,_,_,_,W,_,_,_,_,_,_,_,_,_,_,_,_,_,_,_,_,_,_,_,_,_,_,_,_,_,_,_,_,W,E,_,_,_,_,_,_,_,_,_,_,_,_,_,_,
_,_,_,_,_,_,_,_,_,W,_,_,_,_,_,_,_,_,_,W,_,_,_,_,_,_,_,_,_,_,_,_,_,_,_,_,_,_,_,_,_,_,_,_,_,_,_,_,W,E,_,_,_,_,_,_,_,_,_,_,_,_,_,_,
_,_,_,_,_,_,_,_,_,W,_,_,_,_,_,_,_,_,_,W,_,_,_,_,_,_,_,_,_,_,_,_,_,_,_,_,_,_,_,_,_,_,_,_,_,_,_,_,W,E,_,_,_,_,_,_,_,_,_,_,_,_,_,_,
_,_,_,_,_,_,_,_,_,W,_,_,_,_,_,_,_,_,_,W,_,_,_,_,_,_,_,_,_,_,_,_,_,_,_,_,_,_,_,_,_,_,_,_,_,_,_,_,W,E,_,_,_,_,_,_,_,_,_,_,_,_,_,_,
_,_,_,_,_,_,_,_,_,W,_,_,_,_,_,_,_,_,_,W,_,_,_,_,_,_,_,_,_,_,_,_,_,_,_,_,_,_,_,_,_,_,_,_,_,_,_,_,W,E,_,_,_,_,_,_,_,_,_,_,_,_,_,_,
_,_,_,_,_,_,_,_,_,W,_,_,_,_,_,_,_,_,_,W,_,_,_,_,_,_,_,_,_,_,_,_,_,_,_,_,_,_,_,_,_,_,_,_,_,_,_,_,W,E,_,_,_,_,_,_,_,_,_,_,_,_,_,_,
_,_,_,_,_,_,_,_,_,W,_,_,_,_,_,_,_,_,_,W,_,_,_,_,_,_,_,_,_,_,_,_,_,_,_,_,_,_,_,_,_,_,_,_,_,_,_,_,W,E,_,_,_,_,_,_,_,_,_,_,_,_,_,_,
E,_,_,_,_,_,_,_,_,W,_,_,_,_,_,_,_,_,_,W,_,_,_,_,_,_,_,_,_,_,_,_,_,_,_,_,_,_,_,_,_,_,_,_,_,_,_,_,W,E,_,_,_,_,_,_,_,_,_,_,_,_,_,_,
E,_,_,_,_,_,_,_,_,W,_,_,_,_,_,_,_,_,_,W,_,_,_,_,_,_,_,_,_,_,_,_,_,_,_,_,_,_,_,_,_,_,_,_,_,_,_,_,W,E,_,_,_,_,_,_,_,_,_,_,_,_,_,_,
E,_,_,_,_,_,_,_,_,W,_,_,_,_,_,_,_,_,_,W,_,_,_,_,_,_,_,_,_,_,_,_,_,_,_,_,_,_,_,_,_,_,_,_,_,_,_,_,W,E,_,_,_,_,_,_,_,_,_,_,_,_,_,_,
E,_,_,_,_,_,_,_,_,W,_,_,_,_,_,_,_,_,_,W,W,W,W,W,W,_,_,_,_,_,_,_,_,_,_,_,_,_,_,_,_,_,_,_,_,_,_,_,W,E,_,_,_,0,_,_,_,_,_,_,_,_,_,_,
E,_,_,_,_,_,_,_,_,W,_,_,_,_,_,_,_,_,_,W,W,F,_,_,W,_,_,_,_,_,_,_,_,_,_,_,_,_,_,_,_,_,_,_,_,_,_,_,W,E,_,_,_,_,_,_,_,_,_,_,_,_,_,_,
E,_,_,_,_,_,_,_,_,W,_,_,_,_,_,_,_,_,_,W,W,_,_,_,W,_,_,_,_,_,_,_,_,_,_,_,_,_,_,_,_,_,_,_,_,_,_,_,W,E,_,_,_,_,_,_,_,_,_,_,_,_,_,_,
E,_,_,_,_,_,_,_,_,W,_,_,_,_,_,_,_,_,_,W,W,_,_,_,W,_,_,_,_,_,_,_,_,_,_,_,_,_,_,_,_,_,_,_,_,_,_,_,W,E,_,_,_,_,_,_,_,_,_,_,_,_,_,_,
E,_,_,_,_,_,_,_,_,W,_,_,_,_,_,_,_,_,_,W,W,_,_,_,W,_,_,_,_,_,_,_,_,_,_,_,_,_,_,_,_,_,_,_,_,_,_,_,W,E,_,_,_,_,_,_,_,_,_,_,_,_,_,_,
_,_,_,_,_,_,_,_,_,W,_,_,_,_,_,_,_,_,_,W,W,_,_,_,W,_,_,_,_,_,_,_,_,_,_,_,_,_,_,_,_,_,_,_,_,_,_,_,W,E,_,_,_,0,_,_,_,_,_,_,_,_,_,_,
_,_,_,_,_,_,_,_,_,W,_,_,_,_,_,_,_,_,_,W,W,_,_,_,W,_,_,_,_,_,_,_,_,_,_,_,_,_,_,_,_,_,_,_,_,_,_,_,W,E,_,_,_,_,_,_,_,_,_,_,_,_,_,_,
_,_,_,_,_,_,_,_,_,W,_,_,_,_,_,_,_,_,_,W,W,_,_,_,W,_,_,_,_,_,_,_,_,_,_,_,_,_,_,_,_,_,_,_,_,_,_,_,W,E,_,_,_,_,_,_,_,_,_,_,_,_,_,_,
_,_,_,_,_,_,_,_,_,W,_,_,_,_,_,_,_,_,_,W,W,_,_,_,W,_,_,_,_,_,_,_,_,_,_,_,_,_,_,_,_,_,_,_,_,_,_,_,W,E,_,_,_,_,_,_,_,_,_,_,_,_,_,_,
_,_,_,_,_,_,_,_,_,W,E,_,_,_,_,_,_,_,_,_,_,_,_,_,_,_,_,_,_,_,_,_,_,_,_,_,_,_,_,_,_,_,_,_,_,_,_,_,W,E,_,_,_,_,_,_,_,_,_,_,_,_,_,_,
_,_,_,_,_,_,_,_,_,W,_,_,_,_,_,_,_,_,_,_,_,_,E,_,_,_,_,_,_,_,_,_,_,_,_,_,_,_,_,_,_,_,_,_,_,_,_,_,W,E,_,_,_,_,_,_,_,_,_,_,_,_,_,_,
_,_,_,_,_,_,_,_,_,W,_,_,_,_,_,_,_,_,_,_,_,_,_,_,_,_,_,_,_,_,_,E,_,_,_,_,_,_,_,_,_,_,_,_,_,_,_,_,W,E,_,_,_,_,_,_,_,_,_,_,_,_,_,_,
_,_,_,_,_,_,_,_,_,W,_,_,_,_,_,_,_,_,_,W,_,_,_,_,_,_,_,_,_,_,_,_,_,_,_,_,_,_,_,_,_,_,_,_,_,_,_,_,W,E,_,_,_,_,_,_,_,_,_,_,_,_,_,_,
_,_,0,_,_,_,_,_,_,W,_,_,_,_,_,_,_,_,_,W,_,_,_,_,_,_,_,_,_,_,_,_,_,_,_,_,_,_,_,_,_,_,_,_,_,_,_,_,W,E,_,_,_,_,_,_,_,_,_,_,_,_,_,_,
_,_,_,_,_,_,_,_,_,W,_,_,_,_,_,_,_,_,_,W,_,_,_,_,_,_,_,_,_,_,_,_,_,_,_,_,_,_,_,_,_,_,_,_,_,_,_,_,W,E,_,_,_,_,_,_,_,_,_,_,_,_,_,_,
_,_,0,_,_,_,_,_,_,W,_,_,_,_,_,_,_,_,_,W,_,_,_,_,_,_,_,_,_,_,_,_,_,_,_,_,_,_,_,_,_,_,_,_,_,_,_,_,W,E,_,_,_,_,_,_,_,_,_,_,_,_,_,_,
_,_,_,_,_,_,_,_,_,W,_,_,_,_,_,_,_,_,_,W,_,_,_,_,_,_,_,_,_,_,_,_,_,_,_,_,_,_,_,_,_,_,_,_,_,_,_,_,W,E,_,_,_,_,_,_,_,_,_,_,_,_,_,_,
_,_,0,_,_,_,_,_,_,W,_,_,_,_,_,_,_,_,_,W,_,_,_,_,_,_,_,_,_,_,_,_,_,_,_,_,_,_,_,_,_,_,_,_,_,_,_,_,W,E,_,_,_,_,_,_,_,_,_,_,_,_,_,_,
_,_,_,_,_,_,_,_,_,W,_,_,_,_,_,_,_,_,_,W,_,_,_,_,_,_,_,_,_,_,_,_,_,_,_,_,_,_,_,_,_,_,_,_,_,_,_,_,W,E,_,_,_,_,_,_,_,_,_,_,_,_,_,_,
_,_,_,_,_,_,_,_,_,W,_,_,_,_,_,_,_,_,_,W,_,_,_,_,_,_,_,_,_,_,_,_,_,_,_,_,_,_,_,_,_,_,_,_,_,_,_,_,W,E,_,_,_,_,_,_,_,_,_,_,_,_,_,_,
_,_,_,_,_,_,_,_,_,W,_,_,_,_,_,_,_,_,_,W,_,_,_,_,_,_,_,_,_,_,_,_,_,_,_,_,_,_,_,_,_,_,_,_,_,_,_,_,W,E,_,_,_,_,_,_,_,_,_,_,_,_,_,_,
_,_,_,_,_,_,_,_,_,W,_,_,_,_,_,_,_,_,_,W,_,_,_,_,_,_,_,_,_,_,_,_,_,_,_,0,_,0,_,0,_,_,_,_,_,_,_,_,W,E,_,_,_,_,_,_,_,_,_,_,_,_,_,_,
_,_,_,_,_,_,_,_,_,W,_,_,_,_,_,_,_,_,_,W,_,_,_,_,_,_,_,_,_,_,_,_,_,_,_,_,_,_,_,_,_,_,_,_,_,_,_,_,W,E,_,_,_,_,_,_,_,_,_,_,_,_,_,_,
_,_,_,_,_,_,_,_,_,W,_,_,_,_,_,_,_,_,_,W,_,_,_,_,_,_,_,_,_,_,_,_,_,_,_,_,_,P,_,P,_,P,_,_,_,_,_,_,W,E,_,_,_,_,_,_,_,_,_,_,_,_,_,_,
_,_,_,_,_,_,_,_,_,W,_,_,_,_,_,_,_,_,_,W,_,_,_,_,_,_,_,_,_,_,_,_,_,_,_,_,_,_,_,_,_,_,_,_,_,_,_,_,W,E,_,_,_,_,_,_,_,_,_,_,_,_,_,_,
_,_,_,_,_,_,_,_,_,_,_,_,_,_,_,_,_,_,_,W,_,_,_,_,_,_,_,_,_,_,_,_,_,_,_,_,_,_,_,_,_,_,_,_,_,_,_,_,W,E,_,_,_,_,_,_,_,_,_,_,_,_,_,_,
,,,,,,,,,,,,,,,,,,,,,,,,,,,,,,,,,,,,,,,,,,,,,,,,,,,,,,,,,,,,,,,,
